Eva Fossen	Haugum	evafha@stud.ntnu.no
Nora	Lundquist	noralu@stud.ntnu.no
Elina Kati Nystø	Keskitalo	ekkeskit@stud.ntnu.no
Maja Celin	Brunsvik	majacb@stud.ntnu.no
Vegard Stangebye	Madsen	vegarsma@stud.ntnu.no
Sarah	Kullmann	sarahkul@stud.ntnu.no
Elina Raif	Alnader	elinara@stud.ntnu.no
Riad	Basic	riadb@stud.ntnu.no
Nora Olsen	Myhren	noraom@stud.ntnu.no
Guro Eline	Karlsen	guroeka@stud.ntnu.no
Isak Edlund	Halmrast	isakeh@stud.ntnu.no
Emilie	Rolstad	emilirol@stud.ntnu.no
Christine Ky	Nguyen	chriskng@stud.ntnu.no
Layla Abdinassir	Hunri	laylaah@stud.ntnu.no
Jahn-Aage	Hegg	jahnaagh@stud.ntnu.no
Said Mahamud	Warsame	saidmw@stud.ntnu.no
Forozan	Emami	forozane@stud.ntnu.no
Emil	Endoo	emilend@stud.ntnu.no
Esha Mwinyi	Gjestvang	eshamg@stud.ntnu.no
Vilja Alexandra	Henriksen	viljaah@stud.ntnu.no
Zhenya Ivanova	Zhelyazkova	zhenyaiz@stud.ntnu.no
Viktoria Brodshaug	Langaas	viktorbl@stud.ntnu.no
Adrian Nedkvitne	Tobiassen	adriannt@stud.ntnu.no
Jakub	Olszewski	jakubo@stud.ntnu.no
Martin Kleven	Akersveen	martikak@stud.ntnu.no
Andreas	Nyberg	andny@stud.ntnu.no
Sander Vinkler	Bach	sandebac@stud.ntnu.no
Falke	Brautaset	falkebr@stud.ntnu.no
Leander Kolloen	Amb	leandeka@stud.ntnu.no
Madeleine Lyseggen	Aas	madela@stud.ntnu.no
Mari	Rebne	marirebn@stud.ntnu.no
Ophe	Namata-Nielsen	ophen@stud.ntnu.no
Hanna	Samborska	hannsam@stud.ntnu.no
Maren Skreen	Vognild	marenvog@stud.ntnu.no
Lauritz Rustan	Johansen	lauritzj@stud.ntnu.no
Espen Engdal	Berntsen	espenebe@stud.ntnu.no
Cecilie	Bekkemellem	cecilbek@stud.ntnu.no
Øystein	Røstvik	oystrost@stud.ntnu.no
Mohamud Saleban	Elmi	mohamude@stud.ntnu.no
Kristoffer	Aarsten	kriaars@stud.ntnu.no
Mia	Sanne-Larsen	miasann@stud.ntnu.no
Eirik Hugdahl	Finserås	eirihf@stud.ntnu.no
Liv Marie	Nygård	livmn@stud.ntnu.no
Shu Shu	Somesi	shuss@stud.ntnu.no
Nora	Storrø	norsto@stud.ntnu.no
Modesta	Trakselyte	modestat@stud.ntnu.no
Håkon Andreas	Sæbjørnsen	haakoasa@stud.ntnu.no
Donell Nakim	Stewart	donellns@stud.ntnu.no
Helene Brattheim	Bakke	helebak@stud.ntnu.no
Lukas Larsson	Røtting	lukaslr@stud.ntnu.no
Toril	Hokseggen	torilhok@stud.ntnu.no
Marius Sandvik	Bjørnstad	marsbj@stud.ntnu.no
Even Sondrup	Bentzen	evensbe@stud.ntnu.no
Stian Buhayan	Gabrielsen	stianbga@stud.ntnu.no
Sebastian Forsland	Hveding	sebastfh@stud.ntnu.no
Sanna	Sjøholt	sannasj@stud.ntnu.no
Gustav Grimsmo	Øines	gustavoi@stud.ntnu.no
Saif Ali	Rana	saifar@stud.ntnu.no
Sander	Halvorsen	sandhal@stud.ntnu.no
Kaja Emilie	Berg	kajaeb@stud.ntnu.no
Wisarut	Mortensen	wisarum@stud.ntnu.no
Tobias	Fjellvang	tobiasfj@stud.ntnu.no
Jon Petter	Ervik	jonper@stud.ntnu.no
Mohamed Ahmed	Jama	mohameaj@stud.ntnu.no
Jørgen	Halsa	jorhal@stud.ntnu.no
Helin Sagvan	Abuzed	helinsa@stud.ntnu.no
Karen Tiller	Ekker	karentek@stud.ntnu.no
Vetle	Abrahamsrud	vetleabr@stud.ntnu.no
Khadija Muse	Haji-Adan	khadijah@stud.ntnu.no
Kevin Dela Paz	Enes	kdenes@stud.ntnu.no
Kathinka Linnea	Haugsand	kathinlh@stud.ntnu.no 